1111111111
100E000001
100000P001
100C000001
1111111111
