111111111
1111CP111
11111E111
111111111