111111111
101E10001
101111001
1P001C001
101001001
101001001
101001001
101001001
101001001
101001001
101001001
111111111