111111111111111
1C0000000000001
101111101111101
100000000000001
101010101C10101
1P0000100000001
100000C000C0001
101010101010101
100000E00000001
111111111111111