111111111111111111111111111111111
1P0000C00000000C000000000C000E001
101111111101111111110111111111101
100C0000000000C00000000C000000001
101110111111011101110111011101101
1C00000000C00000000C000000000C001
101111111101111111110111111111101
10000000C0000000C0000000C00000001
101110111111011101110111011101101
1C00000000000C000000000C00000C001
101111111101111111110111111111101
100C0000000000C00000000C000000001
101110111111011101110111011101101
10000000C0000000C0000000C00000001
101111111101111111110111111111101
1C00000000C00000000C000000000C001
101110111111011101110111011101101
100C000000000C000000000C000000001
101111111101111111110111111111101
100000C000000000C0000000C00000001
111111111111111111111111111111111