1111111111111111111111111111111111111111111111111111111111111111111111111111111111111111111111111111111111111111111111111111111111111
1P0000C00000000C000000000C000000100000C00000000C000000000C00000000100C00000000C000000000C00000000000C0000000C000000000C00000000000E01
1011111111011111011101011111111010011111111011111011101111111111001011111111011111101101111111111010011111111011011111101110111111001
100C0000000000C00000000C000000001000C0000000000C00000000C000000000100C0000000000C00000000C000000000000C0000000000C00000000C0000000001
1011101111110111011101010111011010011101111110111011101110111011001011101111110111001101110111011000011101111110011011101110111011001
1C00000000C00000000C000000000C0010C00000000C00000000C000000000C0000C00000000C00000000C000000000C0010000000000C00000000C000000000C0001
1011111111011111011101011111111010011111111011111011101111111111001011111111011111101101111111111000011111111011011111101110111111001
10000000C000000000000000C0000000100000000C000000000000000C0000000010000000C0000000C0000000C0000000000000000C0000000C00000000000000001
1011101111110111011101010111011010011101111110111011101110111011001011101111110111001101110111011010011101111110011011101110111011001
1C00000000000C000000000C00000C0000C00000000000C000000000C00000C0001C00000000000C000000000C00000C00000000000000000000000000C00000C0001
1011111111011111011101011111111010011111111011111011101111111111001011111111011111101101111111111000011111111011011111101110111111001
100C0000000000C00000000C000000001000C0000000000C00000000C000000000100C0000000000C00000000C000000000000C0000000000C00000000C0000000001
1011101111110111011101010111011010011101111110111011101110111011001011101111110111001101110111011010011101111110011011101110111011001
10000000C000000000000000C0000000100000000C000000000000000C0000000010000000C0000000C0000000C0000000000000000C0000000C00000000000000001
1011111111011111011101011111111010011111111011111011101111111111001011111111011111101101111111111000011111111011011111101110111111001
1C00000000C00000000C000000000C0010C00000000C00000000C000000000C0001C00000000C00000000C000000000C0000000000000C00000000C000000000C0001
1011101111110111011101010111011010011101111110111011101110111011001011101111110111001101110111011010011101111110011011101110111011001
100C000000000C000000000C000000001000C000000000C000000000C000000000100C000000000C000000000C000000000000C0000000000000000000C0000000001
100C000000000C000000000C000000001000C000000000C000000000C000000000100C000000000C000000000C000000000000C0000000000000000000C0000000001
100C000000000C000000000C000000001000C000000000C000000000C000000000100C000000000C000000000C000000000000C0000000000000000000C0000000001
1011111111011111011101011111111010011111111011111011101111111111001011111111011111101101111111111000011111111011011111101110111111001
100000C00000000000000000C00000001000000C00000000000000000C00000000100000C000000000C0000000C00000001000000C000000000C00000000000000001
1111111111111111111111111111111111111111111111111111111111111111111111111111111111111111111111111111111111111111111111111111111111111
